3,1,||||
|...*..|
|.#@###|
|##.###|
|h.....|
||||||||