2,1,||||
|...*..|
|..####|
|...###|
|......|
|h....@|
||||||||