|------|
|...*..|
|......|
|..####|
|...###|
|......|
|h....@|
|------|